11111111111
1000W00WC11
100WE101111
10111P00001
10111110101
1C00000W1C1
11111111111