11111111111111111111111111
11E10000000000000W00000001
11011011W11111111111111101
11011011111111111111111101
1P0000000C01C00000000000W1
11111111111111111111111111