11111111111111111111111111111111111111111
1P000111110000000011111111111111110000001
10000111110000000W00000000000000010000001
100W0001100000000011111111111110010000001
1000W000C10000000001E100W0000010010000001
10000000110000000001W10000000010010000001
1111111000000000000W0W000000001CC10000001
1C00000W00000000000WWW0000000001100000001
11111111111111111111111111111111111111111